40
10
9
a b c
+b+b+*+a+*+a+a+*+*+
b*b*b***a*a*a***a*a
+bSa+a+a+*+a+a+a+a+
**b*b***a*a*a******
+b+b+*+*+a+a+e+e+e+
b***c***|***a***e*e
+b+b+b+*+c+*+a+e+e+
****c***c*c***a*e**
+c+*+c+c+*+c+*+a+a+
c*c***c***c*c***a*a
+c+c+c+*+*+c+a+a+*+
d*****d*d*c*c*****a
+d+d+d+d+d+c+c+a+a+
****d*d***d***c***a
+d+d+d+d+d+*+c+*+a+
d*d***d*d***c***a*a
+*+*+d+dDc+c+*+a+a+